101 Dalmatians::101 Natal Maids
3D Maze::Am Zed 3
3D Tunnels::Lend 3 Nuts
Accumulation::I Am Uncut Cola
Adjacent Letters::Calendar Jet Test
Adventure Game::Meet Guava Nerd
Air Traffic Controller::Antarctic Floor Rifler
Alchemy::Hey Clam
Algebra::Lab Gear
Alphabetical Order::A Birthplace Reload
Alphabet Numbers::A Bat Burns Me Help
Alphabet::Bath Leap
Anagrams::A Mr Sagan
Answering Questions::Earn Wings Noses Quit
Astrology::Royals Tog
Backgrounds::Dragon Bucks
Bartending::Intend Brag
Bases::Sea BS
Battleship::Hip Tablets
Benedict Cumberbatch::Butch Em Bent Iced Crab
Big Circle::Big Cleric
Binary LEDs::Badly Risen
Binary Puzzle::Early Buzz Pin
Binary Tree::Bye Terrain
Bitmaps::Ms Pi Bat
Bitwise Operations::Is It Web Arose Point
Black Hole::Be Lo Chalk
Blackjack::Cab JK Lack
Blind Alley::A Lend By Ill
Blind Maze::Me Land Biz
Blockbusters::Rubble Stocks
Blue Cipher::Burp Lichee
Boggle::Log Beg
Boolean Maze::Enable A Zoom
Boolean Venn Diagram::Drag Aim Ban Novel One
Braille::Liberal
British Slang::Snails Bright
Broken Buttons::Stubborn Token
Broken Guitar Chords::A Corgi Dubs Horn Trek
Burglar Alarm::Rural Lamb Rag
Button Masher::Share Tomb Nut
Button Sequence::On Ten Cube Quest
Caesar Cipher::Crisp Ear Ache
Calendar::Red Canal
Capacitor Discharge::It Graced His Orca Cap
Catchphrase::Cash Chapter
Challenge & Contact::Agent Cloth & Cancel
Character Shift::Scratch Hat Fire
Chinese Counting::Eugenic Notch Sin
Cheap Checkout::Oh Cupcake Tech
Chess::SS Ech
Chord Qualities::Quad Ostrich Lie
Christmas Presents::Pens Rest Charm Sits
Coffeebucks::Beck Cue Offs
Color Addition::Cation Lid Door
Color Decoding::Diced Corn Logo
Colored Squares::Dress Or Coequal
Colored Switches::Witches Close Rod
Color Flash::Call For Hos
Colorful Insanity::Run So Fictionally
Colorful Madness::Mad Focus Enrolls
Color Generator::Lone Rotor Grace
Color Match::Halt Mr Coco
Color Math::Roam Cloth
Color Morse::Mr Sore Cool
Combination Lock::Black Coin Motion
Command Prompt::Mr Mod Pant Comp
Complex Keypad::My Explode Pack
Complicated Buttons::Placed Bottom Tunics
Complicated Wires::Rides Camel Tip Cow
Connection Check::Chick Con One Cent
Connection Device::Once Vented Iconic
Cookie Jars::Is Orca Joke
Cooking::Nick Goo
Coordinates::Second Ratio
Countdown::On Duct Now
Crackbox::Cork Cab X
Crazy Talk::Lazy Track
Creation::Rate Icon
Cruel Countdown::Run Coconut Weld
Cruel Piano Keys::Recoup Sky Alien
Cryptography::Try Choppy Rag
Curriculum::I Curl Mu Cur
Cursed Double-Oh::Should Cube-Redo
Decolored Squares::A Corroded Sequels
Determinants::Tanned Mister
DetoNATO::To Donate
Digital Cipher::Pi Acid Lighter
Digital Root::Dog Tail Riot
Discolored Squares::Careless Squid Door
Divided Squares::Revise Dad Squid
Dominoes::Dime Soon
Double-Oh::Blood-hue
Double Color::Cool Boulder
Dr. Doctor::Cord. Trod
Dragon Energy::Grand Grey One
Edgework::Word Geek
Elder Futhark::Father Lurked
Emoji Math::He Omit Jam
Encrypted Morse::Ms Creed Entropy
Encryption Bingo::Benign Cry Option
English Test::Tense Lights
Equations::In Quote As
Error Codes::Score Order
European Travel::A Nepal Overture
Extended Password::Next Spades Worded
Factoring::Acorn Gift
Factory Maze::To Crazy Fame
Fast Math::That Ms Fa
Faulty Backgrounds::Arguably Duck Fonts
Festive Piano Keys::Pokeys Vine Fiesta
Filibuster::Built Fires
FizzBuzz::Bizz Fuzz
Flags::SF Lag
Flashing Lights::Gall Fish Things
Flavor Text EX::To Flax Vertex
Flavor Text::Flat Vortex
Flip The Coin::Fiction Help
Follow the Leader::Defeat Whole Roll
Font Select::Elf Net Cost
Foreign Exchange Rates::A Teachers Genre Foxing
Forget Everything::Very Tethering Fog
Forget Me Not::Ten Foot Germ
Forget This::To Fighters
Free Parking::Fire Rank Peg
Friendship::Shred If Pin
Functions::Unfit Cons
Gadgetron Vendor::Not Graded Govern
Game of Life Cruel::Cameo Figure Fell
Game of Life Simple::Female Implies Fog
Geometry Dash::Gated Rye Ohms
Genetic Sequence::Get Science Queen
Graffiti Numbers::Rift Beam Surfing
Greek Calculus::Glue Us Crackle
Green Cipher::He Rep Cringe
Gridlock::Gold Rick
Grid Matching::Mind Chart Gig
Guitar Chords::Guard Ostrich
Harmony Sequence::Shy Queen Romance
Hexamaze::Haze Exam
Hex To Decimal::Aced Hotel Mix
Hieroglyphics::Holy Pig Riches
Hogwarts::Raw Goths
Homophones::No Home Hops
Horrible Memory::Me Blimey Horror
Hot Potato::Tattoo Hop
HTTP Response::Hen Strep Stop
Human Resources::Ace Nurses Humor
Hunting::Hint Gun
Ice Cream::Mice Race
Identity Parade::Painted Dietary
IKEA::I Eak
Indigo Cipher::Heroic Pidgin
Insanagrams::Assign An Arm
Instructions::Us Or Instinct
Keypad::APK Dye
Knob::Bonk
Know Your Way::Yuk Yo Own Raw
Krazy Talk::Talky Ark Z
Kudosudoku::Duo Kou Dusk
Lasers::Re Lass
Laundry::Run Lady
LED Encryption::Lyric Deponent
LED Grid::Girdled
LED Math::Mat Held
Left And Right::Darling Theft
LEGO::El Go
Letter Keys::Elk Tyre Set
Light Cycle::Eight LLC YC
Lights Out::Tight Soul
Lightspeed::Hedge Split
Lion's Share::Hon's Serial
Listening::In Tin Legs
Logical Buttons::Bacon Guilt Lost
Logic Gates::Locates Gig
Logic::I Clog
Mad Memory::Dear Mommy
Mafia::I Am Fa
Mahjong::Mag John
Maintenance::Mice Antenna
Manometers::Rename Most
Marble Tumble::Met Lemur Blab
Maritime Flags::Legit Mrs Mafia
Mashematics::Sea Mismatch
Mastermind Cruel::Unclear Midterms
Mastermind Simple::Smeared Mint Limps
Math::Hat M
Maze Scrambler::Blame Mrs Craze
Maze::M Eaz
Melody Sequencer::Elm Encodes Query
Memory::Me Or My
Micro-Modules::Room-Dice Slum
Microcontroller::Correct Ill Moron
Mineseeker::Me Rise Keen
Minesweeper::Newer Pi Seem
Modern Cipher::Perched Mr Ion
Module Homework::Lowered Hook Mum
Module Maze::Mum Ole Daze
Modules Against Humanity::Yum Dalmatians Toes In Ugh
Modulo::Om Loud
Monsplode, Fight!::Golfed Months, Pi!
Monsplode Trading Cards::Landscaped Dorm Sorting
Morse-A-Maze::Mrs A-Zee-Roam
Morse Code::Do Some Rec
Morse Identification::A Moist Iron Deficient
Morsematics::Scariest Mom
Morse War::Ear Worms
Mortal Kombat::Mr Balk Tomato
Motion Sense::No Semitones
Mouse In The Maze::Seem To Humanize
Murder::Mr Rude
Mystic Square::Yes Squirm Cat
Needy Mrs Bob::Ye Bomb Nerds
Neutralization::Outran Alien Zit
Nonogram::Moron Nag
Number Nimbleness::Nine Emblems Burns
Number Pad::Damper Bun
Numbers::Burns Me
Only Connect::Cent Con Only
Orientation Cube::Iceboat Neutrino
Painting::Giant Pin
Party Time::I Am Pretty
Passport Control::Clan Troop Sports
Password::Saw Drops
Pattern Cube::Pecan Butter
Pay Respects::Pease Crypts
Periodic Table::Tidier Placebo
Perplexing Wires::Griper Pixel News
Perspective Pegs::I Respect Vegs Pep
Piano Keys::Noisy Peak
Pie::I PE
Pigpen Rotations::Orientating Pops
Playfair Cipher::Reply Hip Africa
Plumbing::Blimp Gun
Poetry::Pry Toe
Point of Order::Portioned For
Poker::Rope K
Polyhedral Maze::Amazed Hype Roll
Press X::SS Prex
Probing::Pig Born
QR Code::CEO Dr Q
Question Mark::A Squirm Token
Quintuples::Lupin Quest
Radiator::Radio Art
Random Number Generator::A Bartender Moon Germ Run
Rapid Buttons::Bad Printouts
Refill that Beer!::Fret Hill Berate!
Regular Crazy Talk::A Larger Lazy Truck
Resistors::Sis Resort
Retirement::Entire Term
Reverse Morse::Me Server Rose
Rhythms::Mrs Hyth
Rock-Paper-Scissors-Lizard-Spock::Socks-Carload-Crops-Zipper-Risks
Rotary Phone::Rare Typhoon
Round Keypad::Yup Dank Redo
Rubik's Clock::Irk Cub's Lock
Rubik's Cube::Rubie's Buck
S.E.T.::E.S.T.
Safety Safe::Eases Taffy
Schlag den Bomb::Belch Bangs Mod
Scripting::Pic String
Sea Shells::Eels Slash
Semaphore::Hear Poems
Shape Memory::My Semaphore
Shapes And Bombs::Mesh Bobs Pandas
Shape Shift::The Spa Fish
Shikaku::Us Khaki
Signals::Is Slang
Silly Slots::Still Lossy
Simon's Sequence::Ms Queen's Conies
Simon's Stages::Tango's Misses
Simon's Star::Smart's Ions
Simon Samples::Misnames Slop
Simon Says::Noisy Mass
Simon Scrambles::Blames Crimsons
Simon Screams::Miss Romances
Simon Sends::Noses Minds
Simon Shrieks::Skirmish Ones
Simon Sings::Missing Son
Simon Sounds::Mid Suns Soon
Simon Speaks::Eskimo Snaps
Simon Spins::Miss No Snip
Simon Squawks::Ms Quasi Knows
Simon States::Season Mitts
Sink::Inks
Skewed Slots::Slowest Desk
Skinny Wires::Sky Is Winner
Skyrim::My Risk
Snooker::Rooks En
Sonic & Knuckles::Conk & Luckiness
Sonic the Hedgehog::Eighth Echoed Song
Souvenir::One Virus
Spinning Buttons::Tin Snot Snub Ping
Splitting The Loot::Telling Tooth Spit
Square Button::Rants Bouquet
Street Fighter::Register Theft
Subways::Buy Saws
Sueet Wall::Wallet Use
Superlogic::Police Rugs
Switches::Chew Sits
Symbol Cycle::My Cos By Cell
Symbolic Coordinates::Cabs Consider Limo Toy
Symbolic Password::Bypass Limo Crowds
SYNC-125 [3]::NYCs-123 [5]
Synchronization::Crazy Thin Onions
Synonyms::My SS Nony
T-Words::Sword-T
Tangrams::Grant Sam
Tap Code::Cape Dot
Tasha Squeals::He Salsa Squat
Tax Returns::Ranters Tux
Ten-Button Color Code::Outdo Nettle-Corncob
Tennis::Nest In
Ternary Converter::Contrary Reverent
Tetris::Sitter
Text Field::Fed Ex Tilt
The Bulb::Belt Hub
The Button::Hot Tub Ten
The Clock::Etch Lock
The Code::Doc Thee
The Crystal Maze::Zesty Cream Halt
The Cube::He Be Cut
The Digit::It Get Hid
The Festive Jukebox::Bee Jive Text Of Husk
The Fidget Spinner::Deepening Thrifts
The Gamepad::Aged Pet Ham
The Hangover::Her Hot Vegan
The Hexabutton::Beneath Hot Tux
The iPhone::Oh Hip Teen
The Jack-O'-Lantern::Can't Not-Heal-Jerk
The Jewel Vault::We Jut Have Tell
The Jukebox::But Hex Joke
The Labyrinth::Try Health Bin
The London Underground::Goldenrod Thunder Noun
The Moon::One Moth
The Number Cipher::Breech Hermit Pun
The Number::Mr Hen Tube
The Plunger Button::Tenth Upturn Globe
The Plunger::Nether Gulp
The Radio::Head Riot
The Screw::Chew Rest
The Sphere::Eh Her Step
The Stock Market::Hack Treks Totem
The Stopwatch::Two Step Hatch
The Sun::Uh Sent
The Swan::New Hats
The Switch::Which Test
The Time Keeper::Met Tepee Hiker
The Triangle::Hanger Title
The Wire::Were Hit
Third Base::Bead Shirt
Tic Tac Toe::Cat Cot Tie
Timezone::Monetize
Tower of Hanoi::Antihero Woof
Turn The Keys::Try Hut Knees
Turn The Key::Then Turkey
Turtle Robot::Torture Bolt
Two Bits::Bit Stow
Ultrastores::Laser Tutors
Uncolored Squares::Our Sons Lacquered
Unfair Cipher::Hi Rip Furnace
Unrelated Anagrams::A Guardsman Eternal
USA Maze::Amaze Us
Valves::Slave V
Varicolored Squares::Discover Quasar Lore
Venting Gas::Vegan Sting
Violet Cipher::Hitler Cove Pi
Visual Impairment::A Minus Lit Vampire
Waste Management::New Nag Teammates
Web Design::Bed Sewing
Westeros::Two Seers
Who's on First::Frown's Hoist
Who's That Monsplode::Topmost How's Handle
Wingdings::Ding Swing
Wire Placement::Replace Me Twin
Wire Sequence::We Quire Scene
Wire Spaghetti::Pirates Weight
Wires::Wiser
Word Scramble::Marble Crowds
Word Search::Crew Hoards
X-Ray::Y-Arx
X01::10X
Yahtzee::Hey Zeta
Zoni::I No Z
Zoo::Ooz
Subscribe to Pewdiepie::I Purities Deep Cobwebs
Grocery Store::Retry Scrooge
Draw::Ward
Burger Alarm::Larger Umbra
Purgatory::Yogurt Rap
Mega Man 2::2 Name Mag
Lombax Cubes::Able Box Scum
The Stare::Theaters
Graphic Memory::Impeach Mr Gyro
Quiz Buzz::IQ Buuzzz
Wavetapping::VIP Agent Paw
The Hypercube::Yep Butch Here
Speak English::Shaking Peels
Stack'em::'Tacks Me
Seven Wires::Reeves Wins
Colored Keys::Yodeler Sock
The Troll::Hell Tort
Planets::Nest Lap
The Necronomicon::Homer Connection
Four-Card Monte::Unread-Comfort
Aa::aA
The Witness::These Twins
The Giant's Drink::Tinker's Night Ad
Digit String::Grid Sitting
Alpha::Ha Pal
Snap!::Naps!
Hidden Colors::Scolded Rhino
Colour Code::Louder Coco
Vexillology::Lily Glove Ox
Brush Strokes::Be Rush Storks
Odd One Out::No Dude Too
The Triangle Button::North Baguette Lint
Mazematics::Sam Zit Acme
Equations X::Quiet Axons
Maze^3::Za Me^3
Yellow Cipher::Hip Celery Owl
Orange Cipher::Charger On Pie
Red Cipher::Priced Her
Faulty RGB Maze::Zebra At Fly Mug
Forget Me Later::Telegram Forte
Garfield Kart::Rag Dirt Flake
Footnotes::To Soft One
Bamboozling Button::Blab Butt Gizmo Noon
Fruits::Surf It
The Modkit::Kited Moth
Tetravex::Ax Tree Tv
Flower Patch::Chapter Wolf
Matchematics::Schematic Mat
Organization::A Train Oozing
Caesar Cycle::Scarcely Ace
Playfair Cycle::Clay Elf Piracy
Cryptic Cycle::Cyclic Cry Pet
Ultimate Cycle::Mutate Icy Cell
Colour Talk::All Cork Out
Bamboozling Button Grid::A Bubbling Ding Zoom Trot
Old Fogey::Goofy Led
The Ultracube::Blue Hut Crate
Snakes and Ladders::Kens Sadder Sandal
Module Movements::Melt Nosedove Mum
Safety Square::Faster Queasy
Roman Numerals::Marmoreal Nuns
The Rule::Lee Hurt
Lousy Chess::Holy Cusses
Keypad Lock::Packed Yolk
Eight Pages::Ape Egg Shit
The Colored Maze::Reached Melt Zoo
White Cipher::Heretic Whip
Gray Cipher::Preachy Rig
Black Cipher::Bar Check Lip
The Hyperlink::Hyphen Kilter
Corners::Scorner
The High Score::Secret High Ho
Ingredients::Needing Stir
Intervals::Van Tilers
Cheep Checkout::Heck Cope Cut He
Thinking Wires::Shriek Twining
Seven Choose Four::Confuse Overshoe
Object Shows::Cob Jew Hosts
Lunchtime::He Cum Lint
Natures::Saunter
Neutrinos::Nine Tours
Scavenger Hunt::Arch Even Stung
Polygons::Slog Pony
Codenames::Encased Om
Odd Mod Out::Dodo To Mud
Blinkstop::Pink Blots
Forget It Not::Gift No Otter
Rainbow Arrows::Raw Barrio Snow
Passcodes::Ed Ass Cops
Digital Dials::A Sail Did Gilt
Lines of Code::Encodes Foil
Encrypted Dice::Cynic Ed Red Pet
Colorful Dials::A Colloid Furls
Atbash Cipher::Beach Harpist
Addition::India Dot
Matrices::Scream It
Cruel Keypads::Capered Sulky
The Black Page::Gal Kept Beach
Simon Forgets::Feigns Motors
Greek Letter Grid::Regretted Elk Rig
Going Backwards::Ragbag Disc Wonk
Scalar Dials::A Cars All Dis
Keywords::Rod We Sky
The Crafting Table::Fractal Beet Thing
Dreamcipher::Preached Rim
Echolocation::Chocolate Ion
Boxing::Gin Box
Railway Cargo Loading::Awarding A Coy Gorilla
Conditional Buttons::A Blond Constitution
Semamorse::Erase Moms
Symbolic Tasha::Libya Stomachs
Alphabetical Ruling::A Lingual Birthplace
Microphone::Niche Promo
Widdershins::Hiders Winds
Lockpick Maze::Zap Mi Elk Cock
Dimension Disruption::Prions Munitions Died
A Message::A Sea Gem
Alliances::Lance Ails
Dungeon::Nudge On
Unicode::Nice Duo
Password Generator::A Transposed Grower
Baccarat::Crab a Cat
Reverse Alphabetize::A Rehab Sieve Pretzel
Alphabetize::He Tip Ablaze
Gatekeeper::Repeat Geek
Five Letter Words::Frittered Wolves
Settlers of KTaNE::Foretastes Knelt
The Hidden Value::Headhunted Evil
Directional Button::A Belt Introduction
The Simpleton::Moth Plenties
Misery Squares::Messy Quarries
Not Wiresword::Twined Sorrow
Not Wire Sequence::Cow Equestrienne
Not Simaze::Zaniest Om
Not Password::Onward Stops
Not Morse Code::Encode Motors
Not Memory::Try One Mom
Not Maze::Zen Atom
Not Keypad::Top Yanked
Not Complicated Wires::A Dielectrics Mop Town
Not the Button::Bent Tooth Nut
Wire Ordering::Rewired Groin
Quaternions::Quaint Snore
Abstract Sequences::Carcass Bequest Ten
Shifting Maze::Fazing Theism
Sorting::Gin Rots
Role Reversal::Realer Lovers
Placeholder Talk::Kelp Toll Charade
Art Appreciation::Catatonia Ripper
Shell Game::Legal Mesh
Pattern Lock::Prattle Conk
Quick Arithmetic::Chimera Quick Tit
Minecraft Cipher::Pitchman Fiercer
Cheat Checkout::The Acute Chock
The Samsung::Mush Agents
Forget The Colors::Reflectors Go Hot
Etterna::Entreat
Recolored Switches::Screeched Oil Trows
Cruel Garfield Kart::Aftercare Drug Kill
Reverse Polish Notation::A Seventieth Roils Porno
Snowflakes::Wolf Snakes
Forget Infinity::Effigy Tin Intro
Stock Images::Casket Gismo
Malfunctions::Fiscal Nun Tom
Minecraft Parody::Dynamic Forepart
NumberWang::Gunman Brew
Minecraft Survival::Fit Vim Vernaculars
Uncolored Switches::Circled Townhouses
The Twin::Wet Hint
Name Changer::Hangmen Race
Just Numbers::Be Mrs Unjust
Lying Indicators::Syndication Girl
Training Text::Extra Tinting
Wonder Cipher::Cornered Whip
Triamonds::Maid Snort
Stars::Tsars
Button Order::Unrobed Tort
Elder Password::Slops Rewarded
Switching Maze::Magics When Zit
Mystery Module::Remedy My Lotus
Ladder Lottery::Treated Lordly
Standard Crazy Talk::Dastardly Czar Tank
Quote Crazy Talk End Quote::Tact Quota Zonked Queerly
Jaden Smith Talk::Hadj Kitten Slam
Deck Creating::Tacked Cringe
Crazy Talk With A K::I Talk Whacky Tzar
BoozleTalk::El Bozo Talk
Arrow Talk::LA Artwork
Audio Morse::I Sum a Rodeo
Palindromes::Ireland Mops
Type Racer::Carpet Rye
Chicken Nuggets::Nun Sets Chick Egg
Tetriamonds::Tandem Trios
Spot the Difference::Effected Horse Pint
Yes and No::Anodynes
Plant Identification::A Tin Infanticide Plot
Integer Trees::Get Reentries
Module Rick::Coiled Murk
Pickup Identification::Iconic Nuked a Fit Pipit
Earthbound::Haunted Orb
Life Iteration::Infertile Iota
Thread the Needle::Tenth Deer Healed
Encrypted Hangman::Canned Great Nymph
Accelerando::Red En Cloaca
The Heart::Hath Tree
Remote Math::Theatre Mom
Password Destroyer::Dad Retypes Sorrows
Brawler Database::Wearable Bastard
More Code::Moor Cede
OmegaForget::Mortgage Foe
Mental Math::Hmm Teal Tan
Dictation::Do Titanic
Basic Morse::Cab Isomers
Emotiguy Identification::A Citified Tenuity Mooing
Jailbreak::Labia Jerk
Dumb Waiters::Wartime Buds
DACH Maze::Hazed Mac
Navinums::Minus Van
Gnomish Puzzle::Ohm Guzzle Pins
Shifted Maze::Theism Fazed
Juxtacolored Squares::Coaxed Quarrels Joust
The Missing Letter::Lengthiest Timers
Amnesia::I Seaman
Synesthesia::Thine Essays
English Entries::Silent Greenish
The Duck::Hut Deck
The Cruel Duck::The Rude Cluck
Identifying Soulless::Ed Infinites Ugly Soils
Ultimate Tic Tac Toe::Tactile Cat Timeout
Factoring::Groin Fact
Lyrical Nonsense::Sir Scalene Nylon
Repo Selector::Elector Poser
Deaf Alley::Flayed Ale
Sound Design::Nosing Dudes
RGB Arithmetic::Cat Birth Grime
Pixel Cipher::I Perplex Chi
The Great Void::Vote Rig Death
Prime Time::Mime Tripe
Negation::No Eating
The Calculator::A Hellcat Court
Ultralogic::Coral Guilt
Spangled Stars::Grassland Pets
Busy Beaver::Survey Babe
Assembly Code::Mossy Debacle
Boomdas::Bad Moos
Needlessly Complicated Button::A Conductible Dent Molley Pests
Color Numbers::Bronco Lemurs
Chinese Strokes::Sketchier Noses
Chalices::Seal Chic
Faulty Accelerando::For A Calculated Yen
Increasing Indices::Acidic Sneering Sin
Faulty Binary::Faintly A Ruby
Cruel Binary::Uric Barn Lye
Connected Monitors::Not Conceited Norms
Broken Binary::Knobbier Yarn
Totally Accurate Minecraft Simulator::Afrocentric Metastatically Tumoural
Tell Me When::Me Went Hell
Alien Filing Colors::Illogical Infernos
The Kanye Encounter::Hoecake Runny Tenet
Entry Number Four::Ferrymen Burnout
Color One Two::Coronet Wool
Spelling Buzzed::Blend Sizzle Pug
Mystic Maze::My Zits Came
Chinese Zodiac::Echidna Cozies
Four Lights::Foul Girths
Working Title::Towering Kilt
One Links to All::Toenail Knolls
Rules::Lures
Double Listening::Boldest Linguine
Wack Game of Life::Magical Week Off
Mindlock::Cold Mink
Regular Hexpressions::A Exospheres Girl Runs
Colored Buttons::Obstruct Noodle
Censorship::Chosen Rips
The Pentabutton::Upbeat Tenth Ton
Mechanis Cipher::Sepia Churchmen
Breaktime::Mite Baker
Three Cryptic Steps::Pretty Screech Pits
The Console::Leech Snoot
Pocket Planes::Kneecap Plots
Rotten Beans::Absent Tenor
Long Beans::Angle Snob
Cool beans::Sole Bacon
Beanboozled Again::Bandana Bozo Liege
The Dials::Head List
Silenced Simon::Lemons Indices
Teal Arrows::Slow Errata
Keep Clicking::Elk Keg Picnic
Alphabet Tiles::Ale Battleship
Double Pitch::Piloted Chub
Devilish Eggs::Vigils Hedges
Quick Time Events::Vim Quest Necktie
The Bioscanner::Rhinestone Cab
Ars Goetia Identification::Aficionados Ignite A Trite
Pixel Number Base::Expansible Umber
Silo Authorization::Lithuania Riot Zoos
Gradually Watermelon::A Warranted Mole Gully